10 10
##########
#S# #   E#
#   #T# ##
# ###   M#
# # #    #
# #    C #
# # #    #
#   # C  #
#   ######
##########